##############################
##################.....#######
#####........######.#.########
############.######.#..#######
#####.##............##......+#
#.....##..####.#########.#####
#####..##.####..########.#####
######....#####..#######.#####
#......#########..######.....#
##############################
------------------------------
##############################
##################.....#######
#####........######.#.########
############.######.#..#######
#####.##............##......+#
#.....##..####.#########.#####
#####..##.####..########.#####
######....#####..#######.#####
#......#########..######.....#
##############################
------------------------------