##############################
##################.....#######
#####@
.......######.#.#####
############.######.#..#######
###.##..........##......+#
#.....##..####.#########.#####
#####..##.####..########.#####
######....##..#######.#####
#......#########..######..#
########################
-------------------------
##############################
##############.....#######
######......######.#.########
############.######.#..######
#####.##............##.......#
#.....#####.#########.##
#####..##.####..########.###
######....#####..#######.#####
#......######..######....+#
##############################
------------------------------