#####
#@###
#..+#
#####
-----
#####
#..+#
#.+##
#####
-----
#####
##..#
#++.#
#####
-----
#####
#+###
#*.##
#####
-----