#########################
##################.....##
#####@.......######.#.###
############.######.#..##
#####.##............##..#
#*#...##..####.#######.##
#.###..##.####..#+..##.##
#.####....#####..##.##.##
#.#....#########..#.##.##
#.#################....##
#.#######################
#.################......#
#.####.......######.#.###
#.##########.######.#..##
#.######............##..#
#.#...##..####.##########
#.###..##.####..#########
#.####....#####..########
#.#....#########..#######
#.####.##########..######
#.#...##..####.###.######
#.###..##.####..##.######
#.####....#####..#.######
#+#....#########...######
#########################
-------------------------
#########################
#########################
####.......##############
##...#####.####.......###
##...###...####.#####.###
##...###.######.#...#.###
##...###.######.#+.##.###
##...###.######....##.###
##.##....############.###
##.##.####............###
##.##.####.##############
##..#..###.##############
###.##.###.##############
#...##.###.##############
#.##...###.##############
#.##.#####.........######
#.##.#############.######
#.#...................###
#.#########.#############
#....#.####.#######.#####
#..###.................##
#.#######.############.##
#.##......####.###.###.##
#+#..####......###.....##
#########################
-------------------------