####################
###@####.#########+#
###.###.......####.#
###.####.####.##...#
###.####.####.##.###
###......####.....##
####################
--------------------
####################
####################
####################
##########......*###
##########.#########
##########+#########
####################
--------------------
####################
#....#............##
###.######..#####.##
###........#......##
###..###########.###
#+......##+........#
####################
--------------------
####################
####...........#####
####.###.#####.#####
####.###+#####.#####
####.###.#####.#####
#+...###.......#####
####################
--------------------
####################
#.............##..+#
#.##.########....###
#.######+####.######
#...........#.######
#.#####.#####......#
####################
--------------------